asphyxiate	STRANGULATION
asphyxiation	STRANGULATION
auto-mutilate	SELF-HARM
auto-mutilating	CUTTING
auto-mutilation	CUTTING
bang	HITTING
banging	HITTING
beat	HITTING
beating	HITTING
bite	BITING
biting	BITING
burn	BURNING
burning	BURNING
chop	CUTTING
chopping	CUTTING
cut	CUTTING
cutting	CUTTING
cutting	CUTTING
destruct	SELF-HARM
destruction	SELF-HARM
destructive	SELF-HARM
drown	SELF-HARM
drowning	SELF-HARM
electrocute	SELF-HARM
electrocuting	SELF-HARM
electrocution	SELF-HARM
gash	STABBING
gouge	STABBING
gouging	STABBING
hack	CUTTING
hacking	CUTTING
hang	STRANGULATION
hanging	STRANGULATION
hit	HITTING
hurt	SELF-HARM
hurting	SELF-HARM
immolate	BURNING
immolating	BURNING
immolation	BURNING
injure	SELF-HARM
injuring	SELF-HARM
injurious	SELF-HARM
injury	SELF-HARM
jump	BURNING
jumping	BURNING
kick	HITTING
kicking	HITTING
lacerate	CUTTING
lacerating	CUTTING
laceration	CUTTING
maim	SELF-HARM
maiming	SELF-HARM
mutilate	CUTTING
mutilating	CUTTING
mutilation	CUTTING
perforate	STABBING
perforating	STABBING
perforation	STABBING
pick	SKIN-PICKING
picking	SKIN-PICKING
pierce	STABBING
piercing	STABBING
pinch	SELF-HARM
pinching	SELF-HARM
poison	OVERDOSE
poisoning	OVERDOSE
pummel	HITTING
pummeling	HITTING
punch	HITTING
punching	HITTING
puncture	HITTING
puncturing	HITTING
rip	SELF-HARM
ripping	SELF-HARM
scald	BURNING
scalding	BURNING
scar	CUTTING
scarring	CUTTING
scratch	CUTTING
scratching	CUTTING
sever	CUTTING
severing	CUTTING
slash	CUTTING
slashing	CUTTING
slice	CUTTING
slicing	CUTTING
slit	CUTTING
slitting	CUTTING
smack	HITTING
stab	STABBING
stabbing	STABBING
strangle	STRANGULATION
strangling	STRANGULATION
tearing	SELF-HARM
throttle	STRANGULATION
throttling	STRANGULATION
whack	HITTING
whacking	HITTING
wound	SELF-HARM
wounding	SELF-HARM